##################################################
#E      # #      # #    #     #        #  #  #   #
# ## ##    # ## #    ## # ## #  ## # #  #   #S # #
# ##  #### #  #   ###     #  ## #   #  # # # ##  #
#   #    # ## # ##   # # # #     ##  #   #    # ##
## # # # #  #  #   #  #    # # #  # # ##  # # #  #
# #   #  # #  #  ## # ####  # # # # #   #   #  # #
#   #   #  ###  #   #     #      #  # #   #  ##  #
# #  # # #    #  ##  # ## ##### #  #   ######   ##
#  #  #   ###  #  ##  # #     ### ## #    #   ## #
# #  #  ##   # ##  ##    ####     #  ## # # ##   #
# # #  #   # #   #   ## #    ## ##  # # ##  #  # #
###  #   ###   #  ##  #  # #####   #   #   ## #  #
#   #  ##   # ###   # ##     ##  #  ## # ##   ####
# ## #  # # ## ## # #   ## #    ###    #  ## #   #
#     ##  #      ## # #   ###### ##### ##  #   # #
# # #   # # #### #   # ##  #      #      # # # # #
# ## ## #  #   # # ##   ## # # ##  # ## #  #  #  #
#    ##  #  # ## # #  #    #  #  # # #  # ###  # #
# # #   # #   #  #   # # # ##  #   ##  ##  # # # #
#  #  # # # ##  # ###   ##   # # ##   #  # # # # #
# ## ##   #  # #    # #    # # #  ## # #   #   # #
##   # # #  #  #### # ## ## ##  #   #  # ##  # # #
#  ###   # #  #   #     #     #  ##   ## #  # #  #
# #    ### # #  #  ### #  ### # #  # #   ####   ##
#  #####   #  #  #    #  #  # # # #   # #     #  #
##       ####  #  ## #  #  #  # # # ##  ## ### # #
#  ## ###  #  # # ##   # #  #     # #  #   #   # #
##   #    #  #  #   # #    # ### #  # # # #  #   #
# ##   ##  #   # # # #  ##   #  #  #  #    ##  # #
#  # # # ### #   # #   #   #  # # #  # ###   ## ##
# #  ##      # ##  ####  ##  #  #  # #    ##     #
# # #   ####  #   #     # # #  # #   ## # # ## # #
#   # ##   # #  ##  ## #    # #   ### # #     #  #
# ###  # #    #    # ## # ###   # #      # ##   ##
##    #   #### ## #     #     ##  # ## #  #   #  #
#  # #  ###      #  # #  # #### # #  # ###  ## # #
# #  ###    # ## # ##  ####     #  # #    ##   # #
#  ##    # ##  ### # #   #  ## # #  #  ##  # # ###
##  # ###  # #     #  ##   # #   ##  #  # #  #   #
# #   #  ##   # ### # # ###  # #  ##  # #   #  # #
# # ## #    #  #        #   #  ##   # ##  #  ### #
#   #   # ## #  ## ####   # ##  # ###   # # #    #
## # ##   #   #   #    # #   ##  #   ## #  #  ## #
#  #  # #  # # ## # # ##  ##  ## # #  #  ##  ##  #
# ###   # ##    #   #   #  ##  #   ##  #   #   # #
#  #  # # #  # ######## ##   ## ###  #  ## # # # #
## ### #  # ##  #   #     ## #     #  # #   #  # #
#        #    #   #   # #      # #   #    #   #  #
##################################################
